X,X,X,X,X,X,X,X,X,X,X,X,X,X,X,X,X,X,X,X,X,X,X,X,X,X,X,X,X,X,X,X,X,X,X,X,X,X,X,X,X,X,X,X,X,X,X,X,X,X,X,X,X,X,X,X,X,X,X,X,X,X,X,X,X,X,X,X,X,X,X,X,X,X,X,X,X,X,X,X,X,X,X,X,X,X,X,X,X,X,X,X,X,X,X,X,X,X,X,X,X,X,X,X,X,X,X,X,X,X,X,X,X,X,X,X,X,X,X,X
X,,,,,,,,,,,,,,,,,,,,,,,,,,,,,,,,,,,,,,,,,,,,,,,,,,,,,,,,,,,,,,,,,,,,,,,,,,,,,,,,,,,,,,*,*,,,,,,,,,,,,,,,,,,,,,,,,,,,,,,,,X
X,,,,,,,,,,,,,,,,,,,,,,,,,,,,,,,,,,,,,,,,,,,,,,,,,,,,,,,,,,,,,,,,,,,,,,,,,,,,,,,,,,,,,,*,*,,,,,,,,,,,,,,,,,,,,,,,,,,,,,,,,X
X,,,,,,,,,,,,,,,,,,,,,,,,,,,,,,,,,,,,,,,,,,,,,,,,,,,,,,,,,,,,,,,,,,,,,,,,,,,,,,,,,,,,,,*,*,,,,,,,,,,,,,,,,,,,,,,,,,,,,,,,,X
X,,,,,,,,,,,,,,,,,,,,,,,,,,,,,,,,,,,,,,,,,,,,,,,,,,,,,,,,,,,,,,,,,,,,,,,,,,,,,,,,,,,,,,*,*,,,,,,,,,,,,,,,,,,,,,,,,,,,,,,,,X
X,,,,,,,,,,,,,,,,,,,,,,,,,,,,,,,,,,,,,,,,,,,,,,,,,,,,,,,,,,,,,,,,,,,,,,,,,,,,,,,,,,,,,,*,*,,,,,,,,,,,,,,,,,,,,,,,,,,,,,,,,X
X,,,,,,,,,,,,,,,,,,,,,,,,,,,,,,,,,,,,,,,,,,,,,,,,,,,,,,,,,,,,,,X,X,X,X,X,X Board-4x1,X,X,X,X,X,X,X,X,,,,,,,,,,,*,*,,,,,,,,,,,,,,,,,,,,,,,,,,,,,,,,X
X,,,,,,,,,,,,,,,,. X,. X,. X,. X,. X,. X,. X,. X,. X,. X,. X,. X,. X,. X,. X,. X,. X,. X,. X,. X,. X,. X,. X,. X,. X,. X,,,,,,,,,,,,,,,,,,,,,X,.,.,.,.,.,.,.,.,.,.,.,.,X,,,,,,,,,,,*,*,,,,,,,,,,,,,,,,,,,,,,,,,,,,,,,,X
X,,,,,,,,,,,,,,,,. X,. CW_F_fam,. ,. ,. ,. ,. Bo,. Bo,. ,. ,. ,. X,. ,. ,. ,. ,. Wa,. Wa,. ,. ,. X,. ,. ,. ,. ,. X,,,,,,,,,,,,,,,,,,,,,X,.,.,.,.,.,.,.,.,.,.,.,.,X,,,,,,,,,,,*,*,,,,,,,,,,,,,,,,,,,,,,,,,,,,,,,,X
X,,,,,,,,,,,,,,,,. X,. ,. ,. ,. ,. ,. ,. ,. ,. ,. ,. X,. ,. ,. ,. ,. ,. ,. ,. Be,. X,. ,. ,. ,. Ba,. X,,,,,,,,,,,,,,,,,,,,,X,.,.,. Ben,.,. Ben,.,.,. Ben,.,. Ben,.,.,X,,,,,,,,,,,*,*,,,,,,,,,,,,,,,,,,,,,,,,,,,,,,,,X
X,,,,,,,,,,,,,,,,. X,. ,. ,. ,. ,. ,. ,. ,. ,. ,. ,. X,. ,. ,. ,. ,. ,. ,. ,. ,. X,. ,. ,. X,. X,. X,,,,,,,,,,,,,,,,,,,,,X,.,.,.,.,.,.,.,.,.,.,.,.,X,X,X,X,X,X,X,X,X,X,,*,*,,,,,,,,,,,,,,,,,,,,,,,,,,,,,,,,X
X,,,,,,,,,,,,,,,,. X,. ,. ,. ,. ,. ,. ,. ,. ,. ,. ,. X,. ,. ,. ,. ,. ,. ,. ,. ,. X,. ,. ,. X,. Wc,. X,,,,,,,,,,,,,,,,,,,,,X,.,.,.,.,.,.,.,.,.,.,.,.,X,. Bo,. Bo,. Bo,. Bo,. Bo,. Bo,. Bo,. Bo,X,,*,*,,,,,,,,,,,,,,,,,,,,,,,,,,,,,,,,X
X,,,,,,,,,,,,,,,,. X,. X,. X,. X,. X,. X,. X,. X,. ,. X,. X,. X,. X,. ,. X,. X,. X,. X,. X,. X,. X,. ,. ,. X,. ,. X,,,,,,,,,,,,,,,,,,,,,X,.,.,. Ben,.,. Ben,.,.,. Ben,.,. Ben,.,.,X,.,.,.,.,.,.,.,.,X,,*,*,,,,,,,,,,,,,,,,,,,,,,,,,,,,,,,,X
X,,,,,,,,,,,,,CW_M_fam,,,. X,. Fr,. ,. ,. ,. ,. ,. ,. ,. ,. ,. ,. ,. ,. ,. ,. Bo,. Bo,. ,. ,. ,. ,. ,. ,. ,. X,,,,,,,Tree-2x2,,,,,,,,,,,,,,X,.,.,.,.,.,.,.,.,.,.,.,.,X,.,.,.,.,.,.,.,.,X,,*,*,,,,,,,,,,,,,,,,,,,,,,,,,,,,,,,,X
X,,,,,,,,,,,,,,,,. X,. ,. ,. ,. ,. ,. ,. ,. ,. ,. ,. ,. ,. ,. ,. ,. ,. ,. ,. ,. X,. X,. X,. X,. X,. X,,,,,,,,,,,,,,,,,,,,,X,.,.,.,.,.,.,.,.,.,.,.,.,X,. Bo,. Bo,. Bo,.,.,. Bo,. Bo,. Bo,X,,*,*,,,,,,,,,,,,,,,,,,,,,,,,,,,,,,,,X
X,,,,,,,,,,,,,,,,. X,. ,. ,. ,. St,. ,. St,. ,. ,. ,. ,. ,. AW_M_fam,. ,. ,. ,. ,. ,. ,. ,. X,. ,. ,. ,. ,. X,,,,,,,,,,,,,,,,,,,,,X,.,.,. Ben,.,. Ben,.,.,. Ben,.,. Ben,.,.,X,.,.,.,.,.,.,.,.,X,,*,*,,,,,,,,,,,,,,,,,,,,,,,,,,,,,,,,X
X,,,,,,,,,,,,,,,,. X,. ,. ,. ,. ,. ,. ,. ,. ,. ,. ,. ,. ,. ,. ,. ,. ,. ,. ,. ,. X,. Be,. ,. ,. Be,. X,,,,,,,,,,,,,,,,,,,,,X,.,.,.,.,.,.,.,.,.,.,.,.,X,.,.,.,.,.,.,.,.,.,*,*,*,,,,,,,,,,,,,,,,,,,,,,,,,,,,,,,,X
X,,,,,,,,,,,,,,,,. X,. ,. ,. ,. Ta,. ,. ,. ,. ,. ,. ,. ,. ,. ,. ,. ,. ,. ,. ,. ,. ,. ,. ,. ,. ,. X,,,,,,,,,,,,,,,,,,,,,X,.,.,.,.,.,.,.,.,.,.,.,.,X,. Bo,. Bo,. Bo,.,.,. Bo,. Bo,. Bo,X,,*,*,,,,,,,,,,,,,,,,,,,,,,,,,,,,,,,,X
X,,,,,,,,,,,,,,,,. X,. ,. ,. ,. St,. ,. St,. ,. ,. ,. ,. ,. ,. ,. ,. ,. ,. ,. ,. ,. ,. ,. ,. ,. ,. X,,,,,,,,,,,,,,,,,,,,,X,.,.,. Ben,.,. Ben,.,.,. Ben,.,. Ben,.,.,.,.,.,.,.,.,.,.,.,X,,*,*,,,,,,,,,,,,,,,,,,,,,,,,,,,,,,,,X
X,,,,,,,,,,,,,,,,. X,. ,. ,. ,. ,. ,. ,. ,. ,. ,. ,. ,. ,. ,. ,. ,. ,. ,. ,. ,. X,. ,. ,. ,. ,. X,,,,,,,,,,,,,,,,,,,,,X,.,.,.,.,.,.,.,.,.,.,.,.,.,.,.,.,.,.,.,.,.,X,,*,*,,,,,,,,,,,,,,,,,,,,,,,,,,,,,,,,X
X,,,,,,,,,,,,,,,,. X,. ,. ,. ,. ,. ,. ,. ,. ,. ,. ,. ,. ,. ,. ,. ,. ,. ,. ,. ,. X,. ,. ,. ,. ,. X,,,,,,,,,,,,,,,,,,,,,X,X,X,X,X,X,.,.,X,X,X,X,X,X,X,X,X,X,X,X,X,X,X,,*,*,,,,,,,,,,,,,,,,,,,,,,,,,,,,,,,,X
X,,,,,,,,,,,,,,,,. X House-25x16,. X,. X,. X,. X,. X,. X,. X,. X,. X,. X,. ,. X,. X,. X,. X,. X,. X,. X,. X,. X,. X,. X,. X,. X,. X,,,,,,,,,GroceryStore-4x3,,,,,,,,,,,,,,,,,,*,*,,,,,,,,,,,,,,,,,*,*,,,,,,,,,,,,,,,,,,,,,,,,,,,,,,,,X
X,,,,,,,,,,,,, ,,,,,,,,,,,,,,*,,,,,,,,,,,,,,,,,,,,,,,,*,*,,,,,,,,,,,,,,,,*,*,,,,,,,,,,,,,,,,,*,*,,,,,,,,,,,,,,,,,,,,,,,,,,,,,,,,X
X,,,,,,,,,,,,,,,,,,,,,,,*,*,*,*,*,*,*,*,*,*,*,*,*,*,*,*,*,*,*,*,*,*,*,*,*,*,*,*,*,*,*,*,*,*,*,*,*,*,*,*,*,*,*,*,*,*,*,*,*,*,*,*,*,*,*,*,*,*,*,*,*,*,*,*,*,*,,,,,,,,,,,,,,,,,,,,,,,,,,,,,,,X
X,,,,,,,,,,,,,,,,,,,,,,,*,*,*,*,*,*,* AW_F,*,*,*,*,*,*,*,*,*,*,*,*,*,*,*,*,*,*,*,*,*,*,*,*,*,*,*,*,*,*,*,*,*,*,*,*,*,*,*,*,*,*,*,*,*,*,*,*,*,*,*,*,*,*,*,*,*,*,*,,,,,,,,,,,,,,,,,,,,,,,,,,,,,,,X
X,,,,,,,,,,,,,,,,,,,,,,,*,,,,,,,,,,,,,,,,,,,,,,,,,,,,,,,,,,,,,,,,,,,,,,,,,,,,,,,,,,,,,,,*,*,,,,,,,,,,,,,,,,,,,,,,,,,,,,,,,,X
X,,,,,,,,,,,,,,,,,,,,,,,*,,,,,,,,,,,,,,,,,,,,,,,,,,,,,,,,,,,,,,,,,,,,,,,,,,,,,,,,,,,,,,,*,*,,,,,,,,,,,,,,,,,,,,,,,,,,,,,,,,X
X,,,,,,,,,,,,,,,,,,,,,,,*,,,,,,,,,,,,,,,,,,,,,,,,,,,,,,,,,,,,,,,,,,,,,,,,,,,,,,,,,,,,,,,*,*,,,,,,,,,,,,,,,,,,,,,,,,,,,,,,,,X
X,,,,,,,,,,,,,,,,,,,,,,,*,,,,,,,,,,,,,,,,,,,,,,,,,,,,,,,,,,,,,,,,,,,,,,,,,,,,,,,,,,,,,,,*,*,,,,,,,,,,,,,,,,,,,,,,,,,,,,,,,,X
X,,,,,,,,,,. X,. X,. X,. X,. X,. X,. X,. X,. X,. X,. X,. X,. X,.,. X,. X,. X,. X,. X,. X,. X,. X,. X,. X,. X,,,,,,,,,,,,,,,,,,,,,,,,,,,,,,,,,,,,,,,,,,,,,,,,,,,,*,*,,,,,,,,,,,,,,,,,,,,,,,,,,,,,,,,X
X,,,,,,,,,,. X,. Fr,.,.,.,.,.,.,.,.,.,.,.,.,. X,.,. Bo,. Bo,.,.,.,.,. Wa,. Wa,. X,,,,,,,,,,,,,,,,,,,,,,,,,,,,,,,,,,,,,,,,,,,,,,,,,,,,*,*,,,,,,,,,,,,,,,,,,,,,,,,,,,,,,,,X
X,,,,,,,,,,. X,.,.,. St,.,. St,.,.,.,.,.,.,.,.,. X,.,.,.,.,. Be,.,.,.,.,. X,,,,,,,,,,,,,,,,,,,,,,,,,,,,,,,,,,,,,,,,,,,,,,,,,,,,*,*,,,,,,,,,,,,,,,,,,,,,,,,,,,,,,,,X
X,,,,,,,,,,. X,.,.,.,.,.,.,.,.,.,.,.,.,.,. X,.,.,.,.,.,.,.,.,.,. X,,,,,,,,,,,,,,,,,,,,,,,,,,,,,,,,,,,,,,,,,,,,,,,,,,,,*,*,,,,,,,,,,,,,,,,,,,,,,,,,,,,,,,,X
X,,,,,,,,,,. X,.,.,. Ta,.,.,.,.,.,.,.,.,.,.,. X,.,.,.,.,.,.,.,.,.,. X,,,,,,,,,,,,,,,,,,,,,,,,,,,,,,,,,,,,,,,,,,,,,,,,,,,,*,*,,,,,,,,,,,,,,,,,,,,,,,,,,,,,,,,X
X,,,,,,,,,,. X,.,.,. St,.,. St,.,.,.,.,.,.,.,.,. X,.,.,.,.,.,.,.,.,.,. X,,,,,,,,,,,,,,,,,,,,,,,,,,,,,,,,,,,,,,,,,,,,,,,,,,,,*,*,,,,,,,,,,,,,,,,,,,,,,,,,,,,,,,,X
X,,,,,,,,,,. X,.,.,.,.,.,.,.,.,.,.,.,.,.,. X,. X,. X,. X,. X,. X,. X,. X,. X,.,. X,,,,,,,,,,,,,,,,,,,,,,,,,,,,,,,,,,,,,,,,,,,,,,,,,,,,*,*,,,,,,,,,,,,,,,,,,,,,,,,,,,,,,,,X
X,,,,,,,,,,. X,.,.,.,.,.,.,.,.,.,.,.,.,.,.,.,.,. Bo,. Bo,. Bo,. Bo,.,.,.,. X,,,,,,,,,,,,,,,,,,,,,,,,,,,,,,,,,,,,,,,,,,,,,,,,,,,,*,*,,,,,,,,,,,,,,,,,,,,,,,,,,,,,,,,X
X,,,,,,,,,,. X,. X,. X,. X,. X,. X,. X,. X,. X,.,.,.,.,.,.,.,.,.,.,.,.,.,.,.,. X,,,,,,,,,,,,,,,,,,,,,,,,,,,,,,,,,,,,,,,,,,,,,,,,,,,,*,*,,,,,,,,,,,,,,,,,,,,,,,,,,,,,,,,X
X,,,,,,,,,,. X,. ,.,.,. Wa,.,.,. Wc,. X,.,.,.,.,.,. X,.,.,.,.,.,.,.,.,.,. X,,,,,,,,,,,,,,,,,,,,,,,,,,,,,,,,,,,,,,,,,,,,,,,,,,,,*,*,,,,,,,,,,,,,,,,,,,,,,,,,,,,,,,,X
X,,,,,,,,,,. X,. Ba,.,.,.,.,.,.,. X,.,.,.,.,.,. X,.,.,.,.,.,.,.,.,.,. X,,,,,,,,,,,,,,,,,,,,,,,,,,,,,,,,,,,,,,,,,,,,,,,,,,,,*,*,,,,,,,,,,,,,,,,,,,,,,,,,,,,,,,,X
X,,,,,,,,,,. X,.,.,.,.,.,.,.,.,.,.,.,.,.,. X,.,.,.,. Ta,.,.,.,.,.,. X,,,,,,,,,,,,,,,,,,,,,,,,,,,,,,,,,,,,,,,,,,,,,,,,,,,,*,*,,,,,,,,,,,,,,,,,,,,,,,,,,,,,,,,X
X,,,,,,,,,,. X,.,.,.,.,.,.,.,.,.,.,.,.,.,. X,.,.,.,.,.,.,.,.,.,. X,,,,,,,,,,,,,,,,,,,,,,,,,,,,,,,,,,,,,,,,,,,,,,,,,,,,*,*,,,,,,,,,,,,,,,,,,,,,,,,,,,,,,,,X
X,,,,,,,,,,. X,.,.,.,.,.,.,.,. X,.,.,.,.,.,. X,.,.,.,.,.,.,.,.,.,. X,,,,,,,,,,,,,,,,,,,,,,,,,,,,,,,,,,,,,,,,,,,,,,,,,,,,*,*,,,,,,,,,,,,,,,,,,,,,,,,,,,,,,,,X
X,,,,,,,,,,. X,.,.,.,.,.,.,.,. X,.,.,.,.,.,. X,.,.,.,.,.,.,.,.,.,. X,,,,,,,,,,,,,,,,,,,,,,,,,,,,,,,,,,,,,,,,,,,,,,,,,,,,*,*,,,,,,,,,,,,,,,,,,,,,,,,,,,,,,,,X
X,,,,,,,,,,. X,. X,. X,. X,. X,. X,. X,. X,. X,. X,. X,. X,. X,. X,. X,. X,. X,. X,. X,. X,. X,. X,. X,. X,. X,,,,,,,,,,,,,,,,,,,,,,,,,,,,,,,,,,,,,,,,,,,,,,,,,,,,*,*,,,,,,,,,,,,,,,,,,,,,,,,,,,,,,,,X
X,,,,,,,,,,,,,,,,,,,,,,,,,,,,,,,,,,,,,,,,,,,,,,,,,,,,,,,,,,,,,,,,,,,,,,,,,,,,,,,,,,,,,,*,*,,,,,,,,,,,,,,,,,,,,,,,,,,,,,,,,X
X,,,,,,,,,,,,,,,,,,,,,,,,,,,,,,,,,,,,,,,,,,,,,,,,,,,,,,,,,,,,,,,,,,,,,,,,,,,,,,,,,,,,,,*,*,,,,,,,,,,,,,,,,,,,,,,,,,,,,,,,,X
X,,,,,,,,,,,,,,,,,,,,,,,,,,,,,,,,,,,,,,,,,,,,,,,,,,,,,,,,,,,,,,,,,,,,,,,,,,,,,,,,,,,,,,*,*,,,,,,,,,,,,,,,,,,,,,,,,,,,,,,,,X
X,,,,,,,,,,,,,,,,,,,,,,,,,,,,,,,,,,,,,,,,,,,,,,,,,,,,,,,,,,,,,,,,,,,,,,,,,,,,,,,,,,,,,,*,*,,,,,,,,,,,,,,,,,,,,,,,,,,,,,,,,X
X,,,,,,,,,,,,,,,,,,,,,,,,,,,,,,,,,,,,,,,,,,,,,,,,,,,,,,,,,,,,,,,,,,,,,,,,,,,,,,,,,,,,,,*,*,,,,,,,,,,,,,,,,,,,,,,,,,,,,,,,,X
X,,,,,,,,,,,,,,,,,,,,,,,,,,,,,,,,,,,,,,,,,,,,,,,,,,,,,,,,,,,,,,,,,,,,,,,,,,,,,,,,,,,,,,*,*,,,,,,,,,,,,,,,,,,,,,,,,,,,,,,,,X
X,,,,,,,,,,,,,,,,,,,,,,,,,,,,,,,,,,,,,,,,,,,,,,,,,,,,,,,,,,,,,,,,,,,,,,,,,,,,,,,,,,,,,,*,*,,,,,,,,,,,,,,,,,,,,,,,,,,,,,,,,X
X,,,,,,,,,,,,,,,,,,,,,,,,,,,,,,,,,,,,,,,,,,,,,,,,,,,,,,,,,,,,,,,,,,,,,,,,,,,,,,,,,,,,,,*,*,,,,,,,,,,,,,,,,,,,,,,,,,,,,,,,,X
X,,,,,,,,,,,,,,,,,,,,,,,,,,,,,,,,,,,,,,,,,,,,,,,,,,,,,,,,,,,,,,,,,,,,,,,,,,,,,,,,,,,,,,*,*,,,,,,,,,,,,,,,,,,,,,,,,,,,,,,,,X
X,,,,,,,,,,,,,,,,,,,,,,,,,,,,,,,,,,,,,,,,,,,,,,,,,,,,,,,,,,,,,,,,,,,,,,,,,,,,,,,,,,,,,,*,*,,,,,,,,,,,,,,,,,,,,,,,,,,,,,,,,X
X,,,,,,,,,,,,,,,,,,,,,,,,,,,,,,,,,,,,,,,,,,,,,,,,,,,,,,,,,,,,,,,,,,,,,,,,,,,,,,,,,,,,,,*,*,,,,,,,,,,,,,,,,,,,,,,,,,,,,,,,,X
X,,,,,,,,,,,,,,,,,,,,,,,,,,,,,,,,,,,,,,,,,,,,,,,,,,,,,,,,,,,,,,,,,,,,,,,,,,,,,,,,,,,,,,*,*,,,,,,,,,,,,,,,,,,,,,,,,,,,,,,,,X
X,,,,,,,,,,,,,,,,,,,,,,,,,,,,,,,,,,,,,,,,,,,,,,,,,,,,,,,,,,,,,,,,,,,,,,,,,,,,,,,,,,,,,,*,*,,,,,,,,,,,,,,,,,,,,,,,,,,,,,,,,X
X,,,,,,,,,,,,,,,,,,,,,,,,,,,,,,,,,,,,,,,,,,,,,,,,,,,,,,,,,,,,,,,,,,,,,,,,,,,,,,,,,,,,,,*,*,,,,,,,,,,,,,,,,,,,,,,,,,,,,,,,,X
X,,,,,,,,,,,,,,,,,,,,,,,,,,,,,,,,,,,,,,,,,,,,,,,,,,,,,,,,,,,,,,,,,,,,,,,,,,,,,,,,,,,,,,*,*,,,,,,,,,,,,,,,,,,,,,,,,,,,,,,,,X
X,,,,,,,,,,,,,,,,,,,,,,,,,,,,,,,,,,,,,,,,,,,,,,,,,,,,,,,,,,,,,,,,,,,,,,,,,,,,,,,,,,,,,,*,*,,,,,,,,,,,,,,,,,,,,,,,,,,,,,,,,X
X,,,,,,,,,,,,,,,,,,,,,,,,,,,,,,,,,,,,,,,,,,,,,,,,,,,,,,,,,,,,,,,,,,,,,,,,,,,,,,,,,,,,,,*,*,,,,,,,,,,,,,,,,,,,,,,,,,,,,,,,,X
X,,,,,,,,,,,,,,,,,,,,,,,,,,,,,,,,,,,,,,,,,,,,,,,,,,,,,,,,,,,,,,,,,,,,,,,,,,,,,,,,,,,,,,*,*,,,,,,,,,,,,,,,,,,,,,,,,,,,,,,,,X
X,,,,,,,,,,,,,,,,,,,,,,,,,,,,,,,,,,,,,,,,,,,,,,,,,,,,,,,,,,,,,,,,,,,,,,,,,,,,,,,,,,,,,,*,*,,,,,,,,,,,,,,,,,,,,,,,,,,,,,,,,X
X,,,,,,,,,,,,,,,,,,,,,,,,,,,,,,,,,,,,,,,,,,,,,,,,,,,,,,,,,,,,,,,,,,,,,,,,,,,,,,,,,,,,,,,,,,,,,,,,,,,,,,,,,,,,,,,,,,,,,,,X
X,,,,,,,,,,,,,,,,,,,,,,,,,,,,,,,,,,,,,,,,,,,,,,,,,,,,,,,,,,,,,,,,,,,,,,,,,,,,,,,,,,,,,,,,,,,,,,,,,,,,,,,,,,,,,,,,,,,,,,,X
X,,,,,,,,,,,,,,,,,,,,,,,,,,,,,,,,,,,,,,,,,,,,,,,,,,,,,,,,,,,,,,,,,,,,,,,,,,,,,,,,,,,,,,,,,,,,,,,,,,,,,,,,,,,,,,,,,,,,,,,X
X,,,,,,,,,,,,,,,,,,,,,,,,,,,,,,,,,,,,,,,,,,,,,,,,,,,,,,,,,,,,,,,,,,,,,,,,,,,,,,,,,,,,,,,,,,,,,,,,,,,,,,,,,,,,,,,,,,,,,,,X
X,,,,,,,,,,,,,,,,,,,,,,,,,,,,,,,,,,,,,,,,,,,,,,,,,,,,,,,,,,,,,,,,,,,,,,,,,,,,,,,,,,,,,,,,,,,,,,,,,,,,,,,,,,,,,,,,,,,,,,,X
X,,,,,,,,,,,,,,,,,,,,,,,,,,,,,,,,,,,,,,,,,,,,,,,,,,,,,,,,,,,,,,,,,,,,,,,,,,,,,,,,,,,,,,,,,,,,,,,,,,,,,,,,,,,,,,,,,,,,,,,X
X,,,,,,,,,,,,,,,,,,,,,,,,,,,,,,,,,,,,,,,,,,,,,,,,,,,,,,,,,,,,,,,,,,,,,,,,,,,,,,,,,,,,,,,,,,,,,,,,,,,,,,,,,,,,,,,,,,,,,,,X
X,,,,,,,,,,,,,,,,,,,,,,,,,,,,,,,,,,,,,,,,,,,,,,,,,,,,,,,,,,,,,,,,,,,,,,,,,,,,,,,,,,,,,,,,,,,,,,,,,,,,,,,,,,,,,,,,,,,,,,,X
X,,,,,,,,,,,,,,,,,,,,,,,,,,,,,,,,,,,,,,,,,,,,,,,,,,,,,,,,,,,,,,,,,,,,,,,,,,,,,,,,,,,,,,,,,,,,,,,,,,,,,,,,,,,,,,,,,,,,,,,X
X,,,,,,,,,,,,,,,,,,,,,,,,,,,,,,,,,,,,,,,,,,,,,,,,,,,,,,,,,,,,,,,,,,,,,,,,,,,,,,,,,,,,,,,,,,,,,,,,,,,,,,,,,,,,,,,,,,,,,,,X
X,,,,,,,,,,,,,,,,,,,,,,,,,,,,,,,,,,,,,,,,,,,,,,,,,,,,,,,,,,,,,,,,,,,,,,,,,,,,,,,,,,,,,,,,,,,,,,,,,,,,,,,,,,,,,,,,,,,,,,,X
X,,,,,,,,,,,,,,,,,,,,,,,,,,,,,,,,,,,,,,,,,,,,,,,,,,,,,,,,,,,,,,,,,,,,,,,,,,,,,,,,,,,,,,,,,,,,,,,,,,,,,,,,,,,,,,,,,,,,,,,X
X,,,,,,,,,,,,,,,,,,,,,,,,,,,,,,,,,,,,,,,,,,,,,,,,,,,,,,,,,,,,,,,,,,,,,,,,,,,,,,,,,,,,,,,,,,,,,,,,,,,,,,,,,,,,,,,,,,,,,,,X
X,,,,,,,,,,,,,,,,,,,,,,,,,,,,,,,,,,,,,,,,,,,,,,,,,,,,,,,,,,,,,,,,,,,,,,,,,,,,,,,,,,,,,,,,,,,,,,,,,,,,,,,,,,,,,,,,,,,,,,,X
X,,,,,,,,,,,,,,,,,,,,,,,,,,,,,,,,,,,,,,,,,,,,,,,,,,,,,,,,,,,,,,,,,,,,,,,,,,,,,,,,,,,,,,,,,,,,,,,,,,,,,,,,,,,,,,,,,,,,,,,X
X,,,,,,,,,,,,,,,,,,,,,,,,,,,,,,,,,,,,,,,,,,,,,,,,,,,,,,,,,,,,,,,,,,,,,,,,,,,,,,,,,,,,,,,,,,,,,,,,,,,,,,,,,,,,,,,,,,,,,,,X
X,,,,,,,,,,,,,,,,,,,,,,,,,,,,,,,,,,,,,,,,,,,,,,,,,,,,,,,,,,,,,,,,,,,,,,,,,,,,,,,,,,,,,,,,,,,,,,,,,,,,,,,,,,,,,,,,,,,,,,,X
X,X,X,X,X,X,X,X,X,X,X,X,X,X,X,X,X,X,X,X,X,X,X,X,X,X,X,X,X,X,X,X,X,X,X,X,X,X,X,X,X,X,X,X,X,X,X,X,X,X,X,X,X,X,X,X,X,X,X,X,X,X,X,X,X,X,X,X,X,X,X,X,X,X,X,X,X,X,X,X,X,X,X,X,X,X,X,X,X,X,X,X,X,X,X,X,X,X,X,X,X,X,X,X,X,X,X,X,X,X,X,X,X,X,X,X,X,X,X,X
