X,X,X,X,X,X,X,X,X,X,X,X,X,X,X,X,X,X,X,X,X,X,X,X,X,X,X,X,X,X,X,X,X,X,X,X,X,X,X,X,X,X,X,X,X,X,X,X,X,X,X,X,X,X,X,X,X,X,X,X,X,X,X,X,X,X,X,X,X,X,X,X,X,X,X,X,X
X,,,,,,,,,,,,,,,,,,,,,,,,,,,,,,,,,,,,,,,,,,,,,,,,,,,,,,,,,,,,,,,,,,,,,,,,,,,,X
X,,,,,,,,,,,,,,,,,,,,,,,,,,,,,,,,,,,,,,,,,,,,,,,,,,,,,,,,,,,,,,,,,,,,,,,,,,,,X
X,,,,,,,,,,,,,,,,,,,,,,,,,,,,,,,,,,,,,,,,,,,,,,,,,,,,,,,,,,,,,,,,,,,,,,,,,,,,X
X,,,,,,,,,,,,,,,,,,,,,,,,,,,,,,,,,,,,,,,,,,,,,,,,,,,,,,,,,,,,,,,,,,,,,,,,,,,,X
X,,,,,,,,,,,,,,,,,,,,,,,,,,,,,,,,,,,,,,,,,,,,,,,,,,,,,,,,,,,,,,,,,,,,,,,,,,,,X
X,,,,,,,,,,,,,,,,,,,,,,,,,,,,,,,,,,,,,,,,,,,,,,,,,,,,,,,,,,,,,,,,,,,,,,,,,,,,X
X,,,,,,,,,,,,,,,,,,,,,,,,,,,,,,,,,,,,,,,,,,,,,,,,,,,,,,,,,,,,,,,,,,,,,,,,,,,,X
X,,,,,,,,,,,,,,,,,,,,,,,,,,,,,,,,,,,,,,,,,,,,,,,,,,,,,,,,,,,,,,,,,,,,,,,,,,,,X
X,,,,,,,,,,,,,,,,,,,,,,,,,,,,,,,,,,,,,,,,,,,,,,,,,,,,,,,,,,,,,,,,,,,,,,,,,,,,X
X,,,,,,,,,,,,,,,,,,,,,,,,,,,,,,,,,,,,,,,,,,,,,,,,,,,,,,,,,,,,,,,,,,,,,,,,,,,,X
X,,,,,,,,,,,,,,,,,,,,,,,,,,,,,,,,,,,,,,,,,,,,,,,,,,,,,,,,,,,,,,,,,,,,,,,,,,,,X
X,,,,,,,,,,,,,,,,,,,,,,,,,,,,,,,,,,,,,,,,,,,,,,,,,,,,,,,,,,,,,,,,,,,,,,,,,,,,X
X,,,,,,,,,,,,,,,,,,,,,,,,,,,,,,,,,,,,,,,,,,,,,,,,,,,,,,,,,,,,,,,,,,,,,,,,,,,,X
X,,,,,,,,,,,,,,,,,,X,X,X,X,X,X,X,X,X,X,X,X,X,X,X,X,X,X,X,X,X,X,X,X,X,X,X,X,X,X,X,X,X,X,X,X,,,,,,,,,,,,,,,,,,,,,,,X
X,,,,,,,,,,,,,,,,,,X,.,.,.,.,.,.,.,.,.,M,M,M,M,M,.,.,.,.,.,.,.,.,X,.,.,.,T,B,B,B,B,T,.,.,X,,,,,,,,,,,,,,,,,,,,,,,X
X,,,,,,,,,,,,,,,,,,X,.,.,.,C,.,C,.,.,.,.,.,.,.,.,.,.,.,.,.,.,.,.,X,.,.,.,.,B,B,B,B,.,.,.,X,,,,,,,,,,,,,,,,,,,,,,,X
X,,,,,,,,,,,,,,,,,,X,.,.,T,T,T,T,T,.,.,.,.,.,.,.,.,.,.,.,.,.,&,&,X,.,.,.,.,B,B,B,B,.,.,.,X,,,,,,,,,,,,,,,,,,,,,,,X
X,,,,,,,,,,,,,,,,,,X,.,.,T,T,T,T,T,.,.,.,.,.,.,.,&,&,.,T,T,.,&,&,X,.,.,.,.,B,B,B,B,.,.,.,X,,,,,,,,,,,,,,,,,,,,,,,X
X,,,,,,,,,,,,,,,,,,X,.,.,.,C,.,C,.,.,.,.,.,.,.,.,&,&,.,T,T,.,&,&,X,.,.,.,.,.,.,.,.,.,.,.,X,,,,,,,,,,,,,,,,,,,,,,,X
X,,,,,,,,,,,,,,,,,,X,.,.,.,.,.,.,.,.,.,.,.,.,.,.,&,&,.,T,T,.,&,&,X,.,.,.,.,.,.,.,.,.,.,.,X,,,,,,,,,,,,,,,,,,,,,,,X
X,,,,,,,,,,,,,,,,,,X,*,.,.,.,.,.,.,.,.,.,.,.,.,.,.,.,.,.,.,.,&,&,X,.,.,.,.,.,.,.,.,.,.,.,X,,,,,,,,,,,,,,,,,,,,,,,X
X,,,,,,,,,,,,,,,,,,X,*,.,.,.,.,.,.,.,.,.,.,.,.,.,.,.,.,.,.,.,.,.,X,.,.,.,.,.,.,.,.,.,.,.,X,,,,,,,,,,,,,,,,,,,,,,,X
X,,,,,,,,,,,,,,,,,,X,*,.,.,.,.,.,*,X,.,.,.,.,.,.,.,.,.,.,.,.,.,.,X,.,.,.,.,.,.,M,M,M,M,M,X,,,,,,,,,,,,,,,,,,,,,,,X
X,,,,,,,,,,,,,,,,,,X,*,.,.,.,.,.,*,X,.,.,.,.,X,X,X,X,X,X,X,X,X,X,X,X,D,X,X,X,X,X,X,X,X,X,X,,,,,,,,,,,,,,,,,,,,,,,X
X,,,,,,,,,,,,,,,,,,X,*,.,.,.,.,.,*,X,.,.,.,.,.,.,.,.,.,.,.,.,.,.,.,.,.,.,X,.,.,.,M,M,M,M,X,,,,,,,,,,,,,,,,,,,,,,,X
X,,,,,,,,,,,,,,,,,,X,*,.,.,.,.,.,*,X,.,.,.,.,.,.,.,.,.,.,.,.,.,.,.,.,.,.,D,.,.,.,.,.,.,.,X,,,,,,,,,,,,,,,,,,,,,,,X
X,,,,,,,,,,,,,,,,,,X,*,*,*,*,*,*,*,X,.,.,.,.,.,.,.,.,.,.,.,.,.,.,.,.,.,.,X,.,.,.,.,.,.,.,X,,,,,,,,,,,,,,,,,,,,,,,X
X,,,,,,,,,,,,,,,,,,X,X,X,X,X,X,X,X,X,.,.,.,.,X,X,X,X,X,X,X,X,X,X,X,X,X,X,X,.,.,.,.,.,.,.,X,,,,,,,,,,,,,,,,,,,,,,,X
X,,,,,,,,,,,,,,,,,,X,.,.,.,.,.,.,.,X,.,.,.,.,X,.,.,.,.,.,.,.,.,.,.,.,.,.,X,.,.,.,.,.,.,.,X,,,,,,,,,,,,,,,,,,,,,,,X
X,,,,,,,,,,,,,,,,,,X,.,.,.,.,.,.,.,X,.,.,.,.,X,.,.,.,.,.,.,.,.,.,.,.,.,.,X,.,.,.,.,.,.,.,X,,,,,,,,,,,,,,,,,,,,,,,X
X,,,,,,,,,,,,,,,,,,X,.,.,.,.,.,.,.,D,.,.,.,.,D,.,.,.,.,.,.,.,.,.,.,.,.,.,X,.,.,.,.,.,T,T,X,,,,,,,,,,,,,,,,,,,,,,,X
X,,,,,,,,,,,,,,,,,,X,X,X,X,X,.,.,.,X,.,.,.,.,X,.,.,.,.,.,.,.,.,.,.,.,.,.,X,B,B,.,.,C,T,T,X,,,,,,,,,,,,,,,,,,,,,,,X
X,,,,,,,,,,,,,,,,,,X,.,.,.,X,.,.,.,X,.,.,.,.,X,X,X,D,X,X,.,.,.,.,.,.,.,.,X,B,B,.,.,.,T,T,X,,,,,,,,,,,,,,,,,,,,,,,X
X,,,,,,,,,,,,,,,,,,X,.,.,.,D,.,.,.,X,.,.,.,.,X,.,.,.,.,X,.,.,.,.,.,.,.,.,X,B,B,.,.,.,.,.,X,,,,,,,,,,,,,,,,,,,,,,,X
X,,,,,,,,,,,,,,,,,,X,.,.,.,X,.,.,.,X,.,.,.,.,X,.,.,.,.,X,.,.,.,.,.,.,.,.,X,B,B,T,.,.,.,.,X,,,,,,,,,,,,,,,,,,,,,,,X
X,,,,,,,,,,,,,,,,,,X,X,X,X,X,X,X,X,X,X,D,D,X,X,X,X,X,X,X,X,X,X,X,X,X,X,X,X,X,X,X,X,X,X,X,X,,,,,,,,,,,,,,,,,,,,,,,X
X,,,,,,,,,,,,,,,,,,,,,,,,,,,,,,,,,,,,,,,,,,,,,,,,,,,,,,,,,,,,,,,,,,,,,,,,,,,,X
X,,,,,,,,,,,,,,,,,,,,,,,,,,,,,,,,,,,,,,,,,,,,,,,,,,,,,,,,,,,,,,,,,,,,,,,,,,,,X
X,,,,,,,,,,,,,,,,,,,,,,,,,,,,,,,,,,,,,,,,,,,,,,,,,,,,,,,,,,,,,,,,,,,,,,,,,,,,X
X,,,,,,,,,,,,,,,,,,,,,,,,,,,,,,,,,,,,,,,,,,,,,,,,,,,,,,,,,,,,,,,,,,,,,,,,,,,,X
X,,,,,,,,,,,,,,,,,,,,,,,,,,,,,,,,,,,,,,,,,,,,,,,,,,,,,,,,,,,,,,,,,,,,,,,,,,,,X
X,,,,,,,,,,,,,,,,,,,,,,,,,,,,,,,,,,,,,,,,,,,,,,,,,,,,,,,,,,,,,,,,,,,,,,,,,,,,X
X,,,,,,,,,,,,,,,,,,,,,,,,,,,,,,,,,,,,,,,,,,,,,,,,,,,,,,,,,,,,,,,,,,,,,,,,,,,,X
X,,,,,,,,,,,,,,,,,,,,,,,,,,,,,,,,,,,,,,,,,,,,,,,,,,,,,,,,,,,,,,,,,,,,,,,,,,,,X
X,,,,,,,,,,,,,,,,,,,,,,,,,,,,,,,,,,,,,,,,,,,,,,,,,,,,,,,,,,,,,,,,,,,,,,,,,,,,X
X,,,,,,,,,,,,,,,,,,,,,,,,,,,,,,,,,,,,,,,,,,,,,,,,,,,,,,,,,,,,,,,,,,,,,,,,,,,,X
X,,,,,,,,,,,,,,,,,,,,,,,,,,,,,,,,,,,,,,,,,,,,,,,,,,,,,,,,,,,,,,,,,,,,,,,,,,,,X
X,,,,,,,,,,,,,,,,,,,,,,,,,,,,,,,,,,,,,,,,,,,,,,,,,,,,,,,,,,,,,,,,,,,,,,,,,,,,X
X,,,,,,,,,,,,,,,,,,,,,,,,,,,,,,,,,,,,,,,,,,,,,,,,,,,,,,,,,,,,,,,,,,,,,,,,,,,,X
X,,,,,,,,,,,,,,,,,,,,,,,,,,,,,,,,,,,,,,,,,,,,,,,,,,,,,,,,,,,,,,,,,,,,,,,,,,,,X
X,,,,,,,,,,,,,,,,,,,,,,,,,,,,,,,,,,,,,,,,,,,,,,,,,,,,,,,,,,,,,,,,,,,,,,,,,,,,X
X,,,,,,,,,,,,,,,,,,,,,,,,,,,,,,,,,,,,,,,,,,,,,,,,,,,,,,,,,,,,,,,,,,,,,,,,,,,,X
X,,,,,,,,,,,,,,,,,,,,,,,,,,,,,,,,,,,,,,,,,,,,,,,,,,,,,,,,,,,,,,,,,,,,,,,,,,,,X
X,,,,,,,,,,,,,,,,,,,,,,,,,,,,,,,,,,,,,,,,,,,,,,,,,,,,,,,,,,,,,,,,,,,,,,,,,,,,X
X,,,,,,,,,,,,,,,,,,,,,,,,,,,,,,,,,,,,,,,,,,,,,,,,,,,,,,,,,,,,,,,,,,,,,,,,,,,,X
X,X,X,X,X,X,X,X,X,X,X,X,X,X,X,X,X,X,X,X,X,X,X,X,X,X,X,X,X,X,X,X,X,X,X,X,X,X,X,X,X,X,X,X,X,X,X,X,X,X,X,X,X,X,X,X,X,X,X,X,X,X,X,X,X,X,X,X,X,X,X,X,X,X,X,X,X
